{	
	"map": [
		[0,0,0,0,0,0,0,0,0,0,0,0,0,0,0,0,0,0,0,0,0,0,0,0,0,0],
		[0,0,0,0,0,0,0,0,0,0,0,0,0,0,0,0,0,0,0,0,0,0,0,0,0,0],
		[0,0,0,0,0,0,0,0,0,0,0,0,0,0,0,0,0,0,0,0,0,0,0,0,0,0],
		[0,0,0,0,0,0,0,0,0,2,2,2,2,2,2,0,0,0,0,0,0,0,0,0,2,0],
		[0,0,0,0,0,0,0,0,2,1,1,1,1,1,1,0,0,0,0,0,0,0,0,0,1,0],
		[0,0,0,0,0,0,0,2,1,1,1,1,1,1,1,0,0,0,0,0,0,0,0,0,1,0],
		[0,0,0,0,0,0,2,1,1,4,4,4,4,4,4,2,0,0,0,0,0,0,0,0,1,0],
		[2,2,2,2,2,2,1,1,4,4,4,4,4,4,4,1,0,0,0,0,0,0,0,0,1,0],
		[1,1,1,1,1,1,1,4,4,4,4,4,4,4,4,1,0,0,0,0,0,0,0,0,1,0],
		[1,1,1,1,1,1,4,4,4,4,4,4,4,4,4,1,2,2,2,2,2,2,2,2,1,2]
	],

	"spawnpoint": {"x": 0, "y": 256},

	"informationalTiles": [
		{
			"x": 1600,
			"y": 512,
			"text": "That's the end, for now!"
		}
	]
}